------------------------------------------------------------------------------------------------------------------------------------------------------------------------------------------------------
------------------------------------------------------------------------------------------------------------------------------------------------------------------------------------------------------
------------------------------------------------------------------------------------------------------------------------------------------------------------------------------------------------------
------------------------------------------------------------------------------------------------------------------------------------------------------------------------------------------------------
------------------------------------------------------------------------------------------------------------------------------------------------------------------------------------------------------
-------------------------------------------------------------------------------------###------------------------------------------------------------------------------------------------##------------
----------------------------------------------------------------------------------------------------------------------------------------------------------------------------------------##------------
-------------------------------------------------------------------------------------------------------------------------------------------------------##-------------------------------##------------
-------------------------------------------------------------------------------------------------------------------------------------------------------##----------------------------#--##------------
------------------------------------------------------------------------------------#####-----------------------------------------------------####-----##---------------------------##--##------------
---------------------------------------##-----##------------------------------------#--------------------------#------------------------------#---------------------------------E--###--##------------
---------------------------------------##-----##------------------------------------#---------------------#----#------------------------------#-----------#---##-----#------------####----------------
---------------------------------------##-----##------------------------------------#---------------------#----#------------------------------#-----------#---##-----#-----------#####------------#---
############################################--#########################################----##################--####################################---################################################
