----------------------------------------------------------------------------------------------------------------------------------------------------------------------------------------------------------------
----------------------------------------------------------------------------------------------------------------------------------------------------------------------------------------------------------------
----------------------------------------------------------------------------------------------------------------------------------------------------------------------------------------------------------------
----------------------------------------------------------------------------------------------------------------------------------------------------------------------------------------------------------------
----------------------------------------------------------------------------------------------------------------------------------------------------------------------------------------------------------------
------------------------------------------------------------------------#-------------------------------------------------------------------------------------------------------------------------##------------
-------------------------------------------------------#-----------------------------------------------------------------#-----------------------------------------------------------------------###------------
------------------------------------------------------------------------------------------------------------------------------------------------------------------------------------------------####------------
-----------------------------------------------------------------------------------------------------------------------------------------------------------------------------------------------#####------------
------------------------------------------------------------------------#---------------------------------------------------------------------------------------------------------------------######------------
-------------------------------------------------------#------------------------------------------------------------------------------------------------------------##-----------------------#######------------
-------------------------------------------------------#--------------#---#----------------------------------------------#------------------------------------------##----------------------########------------
--------------------------------------------#----------#--------------#---#----------------------------------------------#------------------------------------------##---------------------#########--------#---
###########################################################################--#########################################--###--###################################################################################
