-----------------------------------------------------------------------------------------------------------------------------------------------------------------------------------------------------
-----------------------------------------------------------------------------------------------------------------------------------------------------------------------------------------------------
-----------------------------------------------------------------------------------------------------------------------------------------------------------------------------------------------------
---------------------------------------------------------------------------------------------------------------------------------------------------------------------------------------##------------
---------------------------------------------------------------------------------------------------------------------------------------------------------------------------------------##------------
---------------------####---------------------#####-----------####--------#####------####-----------------------------####------------------------------------#####---#----------------##------------
---------------------------------------------------------------------------------------------------------------------------------------------------------------------------------------##------------
---------------------------------------------------------------------------------------------------------------------------------------------------------------------------------------##------------
-----------------#---------------------------------------------------------------------------------------------------------##----------------------------------------------------------##------------
--------###-----##---#-----#-----------##-----#####----------#-----##---####--###---------------##-----------------##------##-----------------------------#---------#-------------##---##------------
---------------###---------#-----------##--------------------------##---------------------------##-----------------##--##--##----------------------#---------------------##------------##------------
--------------####---------##----------##--------------------------##---------------------------##----------##-----##--##--##----------------------#---------------------##------------##------------
-------------#####---------##----------##--------------------------##---------------------------##----------##-----##--##--##----------------------#---------------------##----------#-##--------#---
#####################################################################################----##########---##############################---##########--##################################################
