-----------------------------------------------------------------------------------------------------------------------------------------------------------------------------------------------------
-----------------------------------------------------------------------------------------------------------------------------------------------------------------------------------------------------
-----------------------------------------------------------------------------------------------------------------------------------------------------------------------------------------------------
-----------------------------------------------------------------------------------------------------------------------------------------------------------------------------------------------------
-----------------------------------------------------------------------------------------------------------------------------------------------------------------------------------------------------
---------------------------------------------------------------------------#-------###------------------##########--------###------------------###--###--------------------------------##------------
--------------------------------------------------------------------------------------------------------------------------------------------------------------------------------------###------------
--------------------------------------------------------------------------------------------------------------------------------------#---------------------------------#------------####------------
------------#--#----------------------------------------------------------------------------------------------------------###--------##---------------------------------#-----------#####------------
---------#---------###---------##---------------------#--------------##########--##-------------##------###########-----------------###--------###--###--------#####----#----------######------------
-------------------------##----##-----------------##----------------##--------#--##-------------##---------------------------------####--------------------------------##---------#######------------
-------------------------##----##-----------------##--------##-----###--------#--###------------##---------------------#----------#####--------------------------------##--------########------------
-------------------------##----##-----------------##--------##----####--------#--###------------##---------------------#---------######--------------------------------##-------#########--------#---
######################################---#############################--------#--########################################----##########--#################################---########################
