------------------------------------------------------------------------------------------------------------------------------------------------------------------------------------------------------------------------------
------------------------------------------------------------------------------------------------------------------------------------------------------------------------------------------------------------------------------
------------------------------------------------------------------------------------------------------------------------------------------------------------------------------------------------------------------------------
------------------------------------------------------------------------------------------------------------------------------------------------------------------------------------------------------------------------------
------------------------------------------------------------------------------------------------------------------------------------------------------------------------------------------------------------------------------
------------------#--------------------------------------#-#-------------------------#-------------------------------------------------------####---------------------------------------------------------------##------------
---------------------------------------------------------------------------------------------------------------------------------------------------------------------------------------------------------------###------------
--------------------------------------------------------------------------------------------------------------------------------------------------------------------------------------------------------------####------------
-------------------------------------------------------------------------------------------------------------------------------------------------------------------------------------------------------------#####------------
------------------#--------------------------------------#-#-----------------------####----------------------##--------------##------------########---------------------------------------------------------######---#--------
--------------##--------------------------------------------------------------------------------#------------##--------------##-------------------------------------------------------#--------------------#######------------
--------------##--------------------------------------------------------------------------------#------------##--------------##-----------------------------##------------------------#-------------------########------------
--------------##--------------------------------------------------------------------------------#------------##--------------##-----------------------------##------------------------#------------------#########--------#---
#########################--############################################----###################################################################--#######################---###--########--#####################################
