----------------------------------------------------------------------------------------------------------------------------------------------------------------------------------------------------------
----------------------------------------------------------------------------------------------------------------------------------------------------------------------------------------------------------
----------------------------------------------------------------------------------------------------------------------------------------------------------------------------------------------------------
----------------------------------------------------------------------------------------------------------------------------------------------------------------------------------------------------------
----------------------------------------------------------------------------------------------------------------------------------------------------------------------------------------------------------
----------------------#---------------------------------------------------------########---####--------------#-----------###----####--------------------------------------------------------##------------
-------------------------------------------------------------------------------------------------------------------------------------------------------------------------------------------###------------
------------------------------------------------------------------------------------------------------------------------------------------------------------------------------------------####------------
----------------------------------------------------------------#------------------------------------------------------------------------------------------------------------------------#####------------
----------------#---#####---------------------##---------##------------------###--------------#-----##----#--#--#-----#----------##------#--#----------##--#------------####------------######------------
--------------------------------------##------##---------##-----------------------------------------------------------------------------##--##--------###--##--------------------------#######------------
----------------------------##--------##------##---------##----------------------------------------------------------------------------###--###------####--###-----##--------------##-########------------
----------------------------##--------##------##---------##---------------------------------------------------------------------------####--####----#####--####----##--------------###########--------#---
#####################################################################--###############---################################################################--###############################################
