------------------------------------------------------------------------------------------------------------------------------------------------------------------------------------------------
------------------------------------------------------------------------------------------------------------------------------------########----------------------------------------------------
-----------------------------------------#--########-----------------------------------------------------------------------------#--#-----------------------------------------------------------
-----------------------------------------#--------------------------------------------------------------####---------------------#--#-----------------------------------------------------------
-----------------------------------------------------------#-----------------#---#---#---------------#--#------------#------##---#--#----------------------------------------------#---#---#----
-----------------------------------------------------------#--########-------#---#---#--------####---#--#------------#-----------#--#----------------------------------------------#---#---#----
------------------------------------------##------------------#-----------------------------------------#---------------------------#-----------------------------------------------------------
--------------------------------------------------------------#-----------------------------------------#---------------------------#-----------------------------------------------------------
--------------------------------------------------------------#-----------------------------------------#---------------------------#-----------------------------------------------------------
--------------------------------------------########---------------------------------------------------------------##########-------#-----------#################-------------------------------
################################################################################################################################################################################################
