--------------------------------------------------------------------------------------------------------------------------------
--------------------------------------------------------------------------------------------------------------------------------
--------------------------------------------------------------------------------------------####--------------------------------
--------------------------------------------------------------------------------------------------------------------------------
----------------------------------------------------------------------------##--######----##------------------------------------
----------------------------------------------------########--------------------------------------------------------------------
----------------------------------------------------------------------------------------##--------------------------------------
--------------------------------------------------##----------------------------------------------------------------------------
----------------------------------------------------------------------------------------------------#---#---#-------------------
##################################--##--##--##--##--------------####--##################------------------------################
##################################------------------------------------##################------------------------################
