-----------------------------------------------------------------------------------------------------------------------------------------------------------------------------------------------------
-----------------------------------------------------------------------------------------------------------------------------------------------------------------------------------------------------
-----------------------------------------------------------------------------------------------------------------------------------------------------------------------------------------------------
-------------------------------------------------------------------------------------------------------------------------------------------------------------------------------------------------|---
------------------------------------------------------------------------------------------------------------------------------------------------k------------------------------------------------|---
---------------------------------------------------------------------------+-------*BB------------------BB?BBBMBBB--------BBH------------------B?B--B?B--------------------------------##--------|---
--------------------------------------------------------------------------------------------------------------------------------------------------------------------------------------###--------|---
--------------------------------------------------------------------------------------------------------------------------------------#---------------------------------#-----------k####--------|---
------------?--M---------------V------------------------------------------g-gg------------------V------------h------------BBB-------g##---------------------------k-----#-----------#####--------|---
---------?-K------KBBB---V-----[]-----------------V---B--------------##########--##-------------[]------BBBBBBBBBBB----------------g###--------B?B--BMB--------BOBBB----#----------######--------|---
-------------------------[]----pP-----------------[]--------V-------##--------#--##-------------pP---------------------------------####---------------------K--K-------##--------k#######--------|---
-------------------------pP----pP-----------------pP--------[]-----###--------#--###------------pP---------------------Y----------#####----------------------------K---##--------########--------|---
-------------------------pP--g-pP-----------gg-g--pP-k------pP----####--------#--###--g-g---k---pP---------------------Y---------######------k-----g-gg----------------##-------#########--------#---
######################################---#############################--------#--########################################----##########--#################################---########################