-------------------------------------------------------------------------------------------------------------------------------------------E----------------------------------------------------
----------------------------------------------*-E--E------------------------------------------A----J----------------------T---------XXXXXXXX----------------------------------------------------
-----------------------------------------X--XXXXXXXX-----------------------------------------------------------------------------X--X-----------------------------------------------------------
-----------------------------------------X----------------------%--%------------------------------------XXXXF--------------------X--X-----------------------------------------------------------
-----------------------------------------------------------X---------E-------X---X---X---------E-----X--X------------X------XX---X--X-------W--------------------------------------X---X---X----
----------------------------------------)-----------+------X--XXXXXXXX-------X---X---X--------XXXX---X--X------------X-----------X--X----------------------------------------------X---X---X----
------------------------------------------XX------------------X-----------------------------------------X%-------------------+------X---------------------------%-------------------------------
-----------------------%---%----------------------------------X----------------------------+------------X---------------------------X-------%---------------------------------------------------
-----------------------------------------------D--------------X-----------------------------------------X--------------E---E--------X----------------E-E--E-------------------------------------
-P--------------E-E--E-D---------E-----E----XXXXXXXX---------E----------D---------E-----------------------D--------XXXXXXXXXX------EX-----------XXXXXXXXXXXXXXXXX-E--D------------E--E---E------
XXXXXXXXXXXXXXXXXXXXXXXXXXXXXXXXXXXXXXXXXXXXXXXXXXXXXXXXXXXXXXXXXXXXXXXXXXXXXXXXXXXXXXXXXXXXXXXXXXXXXXXXXXXXXXXXXXXXXXXXXXXXXXXXXXXXXXXXXXXXXXXXXXXXXXXXXXXXXXXXXXXXXXXXXXXXXXXXXXXXXXXXXXXXXXXX
