XX--------------------------------------------------------------------------------------------------------------------------LXXX@@@@@@@@@@@@@@@@@@@@@@@@@@@@@@@@XXXX----------------------------------------------------------XX
XX-------------------------------------------------------------------------------------------------------------B------------LXXX@@@@@@@@@@@@@@@@@@@@@@@@@@@@@@@@XXXX----------------------------------------------------------XX
XX------------------------+------------------------------------------------------J-----+------------------------------------LXXX@@@@@@@@@@@@@@@@@@@@@@@@@@@@@@@@XX-----------------------+------------------------------------XX
XX-----------------------------------------------%------------------------------------------------------------XXXXXXXXXXXX--LXXX@@@@@@@@@@@@@@@@@@@@@@@@@@@@@@@@XX---)--------------------------------------------------------XX
XX--------------------------E-E-------+-------------------A-------------------------------EE----%---%-----------XX----------LXXX@@@@@@@@@@@@@@@@@@@@@@@@@@@@@@@@XX-----------------------E-E---E-----)---%--------------------XX
XX------------------------XXXXXX------------------------------------------------XXXXXXXXXXXX--------------------XX----------LXXX@@@@@@@@@@@@@@@@@@@@@@@@@@@@@@@@XX----------------------XXXXXXXXX-----------------------------XX
XX--------------------------XX-------E-----------------E-----------)-------E------XX----XX------E--E------------XX----------LXXX@@@@@@@@@@@@@@@@@@@@@@@@@@@@@@@@XX-------------*--------XXXXXXXXX----E------E-E---------------XX
XX--------------------------XX----XXXXXX--------XXXXXXXXXX----------------XX------XX----XX----XXXXXXXX----------XX--LX------LXXX@@@@@@@@@@@@@@@@@@@@@@@@@@@@@@@@XX----LX----------------XXXXXXXXX--XXXXXXXXXXXX---X-----------XX
XX------E--E--E-------------XX------XX----------XXXXXXXXXX--------EE------XX------XX----XX--------XX-----E------XX--LX------XXXX@@@@@@@@@@@@@@@@@@@@@@@@@@@@@@@@XX----LX-----E----------XXXXXXXXX-----XX----XX----XX--------P-XX
XXXXXXXXXXXXXXXX----XX------XX------XX----XXXXXXXXXXXXXXXXXXXXXXXXXXXXXX--XX------XX----XX--------XX----XX------XX--LXXXXXXXXXXX@@@@@@@@@@@@@@@@@@@@@@@@@@@@@@@@XXXX--LXXXXXXXXXXXXXXXXXXXXXXXXXX-----XX----XX----XXXXXXXXXXXXXX
XX--------XX--------XX------XX------XX----------XXXXXXXXXXXXXXXXXXXXXXXX--XX------XX----XX--------XX----XX------XX--LX@@@@@@@@@@@@@@@@@@@@@@@@@@@@@@@@@@@@@@@@@@@@XX--LX------XX--------XXXXXXXXX-----XX----XX----XX----XX----XX
@@@@@@@@@@@@@@@@@@@@@@@@@@@@@@@@@@@@@@@@@@@@@@@@@@@@@@@@@@@@@@@@@@@@@@@@@@@@@@@@@@@@@@@@@@@@@@@@@@@@@@@@@@@@@@@@XX--LX@@@@@@@@@@@@@@@@@@@@@@@@@@@@@@@@@@@@@@@@@@@@XX--LX------XX@@@@@@@@@@@@@@@@@@@@@@@@@@@@@@@@@@@@@@@@@@@@@@@@
@@@@@@@@@@@@@@@@@@@@@@@@@@@@@@@@@@@@@@@@@@@@@@@@@@@@@@@@@@@@@@@@@@@@@@@@@@@@@@@@@@@@@@@@@@@@@@@@@@@@@@@@@@@@@@@@XX--LX--------------------------------------------XX--LX------XX@@@@@@@@@@@@@@@@@@@@@@@@@@@@@@@@@@@@@@@@@@@@@@@@
@@@@@@@@@@@@@@@@@@@@@@@@@@@@@@@@@@@@@@@@@@@@@@@@@@@@@@@@@@@@@@@@@@@@@@@@@@@@@@@@@@@@@@@@@@@@@@@@@@@@@@@@@@@@@@@@XX--LX--------------------------------------------XX--LX------XX@@@@@@@@@@@@@@@@@@@@@@@@@@@@@@@@@@@@@@@@@@@@@@@@
@@@@@@@@@@@@@@@@@@@@@@@@@@@@@@@@@@@@@@@@@@@@@@@@@@@@@@@@@@@@@@@@@@@@@@@@@@@@@@@@@@@@@@@@@@@@@@@@@@@@@@@@@@@@@@@@XX--LX------------------------------F-------------XX----------XX@@@@@@@@@@@@@@@@@@@@@@@@@@@@@@@@@@@@@@@@@@@@@@@@
@@@@@@@@@@@@@@@@@@@@@@@@@@@@@@@@@@@@@@@@@@@@@@@@@@@@@@@@@@@@@@@@@@@@@@@@@@@@@@@@@@@@@@@@@@@@@@@@@@@@@@@@@@@@@@@@XX--LX--------------------------------------------XX----------XX@@@@@@@@@@@@@@@@@@@@@@@@@@@@@@@@@@@@@@@@@@@@@@@@
@@@@@@@@@@@@@@@@@@@@@@@@@@@@@@@@@@@@@@@@@@@@@@@@@@@@@@@@@@@@@@@@@@@@@@@@@@@@@@@@@@@@@@@@@@@@@@@@@@@@@@@@@@@@@@@@XX---+-------E--)---------%------E------R---------XX----------XX@@@@@@@@@@@@@@@@@@@@@@@@@@@@@@@@@@@@@@@@@@@@@@@@
@@@@@@@@@@@@@@@@@@@@@@@@@@@@@@@@@@@@@@@@@@@@@@@@@@@@@@@@@@@@@@@@@@@@@@@@@@@@@@@@@@@@@@@@@@@@@@@@@@@@@@@@@@@@@@@@XX----------XX------------------XX------------XX--XXXXXXXXXX--XX@@@@@@@@@@@@@@@@@@@@@@@@@@@@@@@@@@@@@@@@@@@@@@@@
@@@@@@@@@@@@@@@@@@@@@@@@@@@@@@@@@@@@@@@@@@@@@@@@@@@@@@@@@@@@@@@@@@@@@@@@@@@@@@@@@@@@@@@@@@@@@@@@@@@@@@@@@@@@@@@@XX---E------XX------------------XX------------XX--------------XX@@@@@@@@@@@@@@@@@@@@@@@@@@@@@@@@@@@@@@@@@@@@@@@@
@@@@@@@@@@@@@@@@@@@@@@@@@@@@@@@@@@@@@@@@@@@@@@@@@@@@@@@@@@@@@@@@@@@@@@@@@@@@@@@@@@@@@@@@@@@@@@@@@@@@@@@@@@@@@@@@XXXXXXXX----XX--XX--------XX----XX--XX--XX----XX--------------XX@@@@@@@@@@@@@@@@@@@@@@@@@@@@@@@@@@@@@@@@@@@@@@@@
@@@@@@@@@@@@@@@@@@@@@@@@@@@@@@@@@@@@@@@@@@@@@@@@@@@@@@@@@@@@@@@@@@@@@@@@@@@@@@@@@@@@@@@@@@@@@@@@@@@@@@@@@@@@@@@@XX--XX------XX--XX--E-----XX----XX--XX--XX-B--XXXXXXXXXXXXXXXXXX@@@@@@@@@@@@@@@@@@@@@@@@@@@@@@@@@@@@@@@@@@@@@@@@
@@@@@@@@@@@@@@@@@@@@@@@@@@@@@@@@@@@@@@@@@@@@@@@@@@@@@@@@@@@@@@@@@@@@@@@@@@@@@@@@@@@@@@@@@@@@@@@@@@@@@@@@@@@@@@@@XX--XX------XX--XX--XX----XX----XX--XX--XX----XXXXXXXXXXXXXXXXXX@@@@@@@@@@@@@@@@@@@@@@@@@@@@@@@@@@@@@@@@@@@@@@@@
@@@@@@@@@@@@@@@@@@@@@@@@@@@@@@@@@@@@@@@@@@@@@@@@@@@@@@@@@@@@@@@@@@@@@@@@@@@@@@@@@@@@@@@@@@@@@@@@@@@@@@@@@@@@@@@@XX--XX------XX--XX--XX----XX----XX--XX--XX----XX@@@@@@@@@@@@@@XX@@@@@@@@@@@@@@@@@@@@@@@@@@@@@@@@@@@@@@@@@@@@@@@@
