#------------###
#-------------##
#------#---#--##
#---############
#--#############
##-#------------
##-#------------
#------#-------#
#-#------------#
#--------------#
#------#-------#
########-------#
####---####----#
---------------#
-----------##--#
---------------#
---------------#
-------------###
---------------#
------##########
------##--------
------##--------
########----####
----------------
----------------
--------####----
--------####----
------######----
----------------
---####---------
---##-----------
#####-----######
----------##----
-------#####----
----------------
----####--------
----------------
----------------
--#-------------
----------------
-----#--#--#----
----------------
----------------
-------------#--
-------------#--
-------------#--
--####--#--#-#--
--#--#--#--#----
--#--#--#--#----
###--#--#--#----
----------------
----------------
########--------
----------------
--------#-------
----------------
--------#-------
----------------
----------------
#-----####-#####
#---------------
#---------------
#----------##---
#----------##--#
#-----########-#
#-----##-------#
#--#####-------#
#--#------######
#--#----------##
##-#----------##
#--#-####-----##
#--#----------##
#-##----------##
#--#-----####-##
#--#----------##
##-#----------##
#--#####------##
#--#----------##
#-##-----------#
#--#----####---#
#--#-----------#
##-#-----------#
#--#####-------#
#--#-----------#
#-##-----####--#
#--#-----------#
#--#----------##
##-#----------##
#--#----------##
#--#---#########
--##---##-------
---#---##-------
---#-####-------
####---##-----##
####---##---####
######-##-----##
####---##-----##
------#---##----
----------------
----------------
-----#####------
----------------
----------------
---####--####---
----------------
----------------
-------##--####-
----------------
----------------
-----##--##-----
----------------
----------------
------#---##----
----------------
----------------
-----#####------
----------------
----------------
---####--####---
----------------
----------------
-------##--####-
----------------
----------------
-----##--##-----
----------------
----------------
--##------------
--#####---------
-----##---------
-----#####------
--------##------
--------#####---
-----------##---
####-------#####
--##-----------#
--#####--------#
-----##--------#
-----#####-----#
---------##----#
---------##----#
---------------#
------------####
------------##--
---------#####--
---------##-----
------#####-----
------##--------
---#####--------
---##-----------
---##-----------
####----------##
####----------##
####----------##
####----########
---#-#----------
---#------------
###-----------##
##########----##
##------------##
##------------##
##----##########
##------------##
##------------##
########------##
##----#####---##
##------------##
##------------##
#####-------####
################
