####----------##
#-------------##
#-------------##
#-----##########
#-----##########
####-----####---
####-----####---
####--------####
####-#------####
#-----------####
#-----------####
#---#--#########
#--------------#
#--------------#
#########------#
####------------
#--------#------
----------------
----------------
----########----
-----------#----
-----------#----
##----------####
##--------------
##--------------
####----##------
####------------
####------------
####----#-------
--------#-------
--------#-------
--------#-#-----
----------------
----------------
--------#---##--
----------------
----------------
####----------##
####----------##
####----------##
####------######
----------------
----------------
------##--------
----------------
-#--------------
##----------####
##--------------
##--------------
##-----##-------
----------##----
----------##----
--####----------
----------------
----------------
-------##---#---
----------------
----------------
-----##-#-------
----------------
----------------
####----##----##
#-------------##
#-------------##
#--##---------##
##--------------
##--------------
####--------####
####--------####
#######-----####
####------#-####
##----------####
##----------####
##----##########
##--------------
##--------------
######----------
##--------------
----------------
-----####-------
----------------
----------------
--------####----
----------------
--------------#-
----------------
----------------
-----#---#---#--
--#--#---#---#--
--#--#---#---#--
--#--#---#---#--
--#-#-----------
----------------
----------------
----#####-------
----------------
----------------
------####------
----------------
---####---------
----------------
----------------
####------######
#---------------
#---------------
#------####-----
#---------------
##--------------
##--####--------
##--------------
#####-----------
----------------
---####---------
----------------
------####------
----------------
---------####---
----------------
####--------####
----------------
---####---------
----------------
------####------
----------------
---------####---
----------------
----------------
#########----###
#------------###
#------------###
#--#---------###
----------------
----------------
-#--------------
----------------
----#---##------
--------##------
--------##------
--------#####---
####--------####
----------------
----------------
---######-------
----------------
--------####----
----------------
########----####
----------------
----------------
-----####-------
----------------
----#----####---
----------------
----------------
--####-----####-
--------#-------
--------#-------
------####------
----------------
----------------
--####----####--
----------------
----------------
####-------#####
----------------
----------------
---####---------
----------------
----------------
##-----####---##
##------------##
##------------##
######----######
##------------##
##------------##
#-----####-----#
---------####---
----------------
----------------
##-----------###
##------------##
#########-----##
##------------##
----------------
---------####---
----------------
----------------
##------########
##------------##
##------------##
####----------##
####-----------#
####-----------#
############---#
###########----#
####----------##
##-------------#
##-------------#
#####---########
################
