--------------------------------
---------H########--------------
---------H-------######---------
###########H--------------------
-----------H--------------------
-----------H#######-#######H##--
-----------H---------------H----
-----------H---------------H----
###########H---------------H----
###########H###########----H####
###########H---------------H----
###########H---------------H----
##------###H-----------HHHHH----
##------###H---------##----H----
##------###H---------------H----
##------###H---------------H----
##------###H---------------H----
############H#########H----H----
------------H---------#########H
------------H------------------H
------------H------------------H
################################
