--------------------------------
--------------------------------
--------------------------------
--#####################H--------
##---------------------H--------
-------------H#########H--------
-------------H---------H--------
-------------H---------H#######-
-------------H------------------
---H##########HHHHHHHHH---------
---H----------H-------H########H
---H----------H-------H--------H
---H----------H-------H--------H
###H----------H-------H--------H
--------H#####H#######H---H#####
--------HHHHHHHHHH--------H----#
--------H------------H####H-----
#########H-----------H----H-----
---------H-----------H----H#####
---------H-----------H----------
---------H-----------H----------
---------H-----------H----------
