--------------------------------
------------------------HHHHHHHH
------------------------H------H
#####H##----#H###-------H------H
-----H-------H------####H#######
-----H-------H----------H-------
-----H-------H----------H-------
-----H-------H----------H--#----
#####H#####--H----------H-------
-----H-------H----------H--#----
-----H-------H----------H-------
-----H-------H----------H-------
-----H-------H----------H-------
##H##########H####H-----H-------
--H---------------H-----H-####-H
--H---------------HHHHHHH-####-H
--H----------#----------H-#--#-H
########H---------------H-#####H
--------H----#---#-#----H------H
--------H---------------H------H
--------H---------------H------H
################################
