--------------------------------
-HHHHHHHHHHHHH------------------
H-------H-----#---#-----H-------
H------HHH----#####----HHH------
H-------H---------------H-------
H---HH--H--HH-------HH--H--HH---
H---H-HHHHH-H-------H-HHHHH-H---
H---H-HHHHH-H---H---H-HHHHH-H---
H---H-------H--HHH--H-------H---
H----H#####H----H----H#####H----
H-----HHHHH-HH--H--HH-HHHHH-----
H-----------H-HHHHH-H-----------
H-----------H-HHHHH-H-----------
H-----------H-HHHHH-H-----------
H-----------H-------H-----------
H------------H#####H------------
H#######H-----HHHHH-----H#######
H-------H---------------H-------
H-------H---------------H-------
H-------H---------------H-------
H-------H---------------H-------
################################
