--------------------------------
--------------------------------
------------##########H---------
----------------------H---------
----------------------H#H######H
-------######H--------H-H------H
########-----HHHHHHHHHH-H------H
-------------H--------H-########
-------------H--------H---------
-------------H--------HHHHHHHHHH
##H##########H--------H---------
--H----------H--------H---------
--H----------H--------H---------
############-#########H-----####
----------------------H---------
----------------------H---------
######H########H------H---------
------H--------################H
------H------------------------H
------H------------------------H
------H------------------------H
################################
