--H--------------H-HH----HH-----
--H---------------HH-H---H-H---H
-HH----HHH--------HH--H--H--H--H
H-H---H-H-H------H-H---H-H---H-H
--H--H--H--H----H--H----HH----HH
--H-H---H---H--H---H-----H-----H
HHHH----H----HH----H-----H-----H
H-H-----H----HH----H-----H----HH
H--H----H---H------HHHHHHHHHHH-H
HH--HH--H----H-----H---------H-H
H---HH--H--HHH-----H--------HH-H
H--H-H--HHH--H----HHH------H-H-H
H-H--H--H----H---H-H-H----H--H-H
HH----H-HH---H--H--H--H--H---H-H
H-H----HH----H-H---H---HH-H--H-H
HH-HH--------HH-H--H---H---H-H-H
H-H-H---H----H---H--H-H-----HH-H
H--HH-H--H---HH---H--H-------H-H
HHH-H-----H--H-H---H--H-H----H-H
H--HH----H-H-H--H---HH-H-HH-HHH-
H---H---H---HH---H-----------H--
----H------------------------H--
