--------------------------------
H####################H------H---
H--------------------HHHHHHHH---
######################------H---
##########H-----------------H---
#########HH-----------------H###
##----##HHHHHHHHHHHH--------H---
##----##HH---------H--------H---
#######HH----------H--------H---
#######HH----------H--------H---
######HH-----H##############H###
######HH-----H--------------H---
------H------H--------------H---
------H------H--------------H---
------H------HHHHHHHHHHHHHHHH---
------H------H--------------H---
H############H--------------H###
H------------H-############-H---
H------------H--------------H---
H------------H--------------H---
H------------H--------------H---
################################
