-------------------------------H
H#####H------------------------H
H-----H------------------------H
H-----H------H###########H-----H
H-----H------H-----------H-----H
H#####H------H-----------H#####H
H-----HHHH---H-----------H------
H-----H------H-----------H------
H-----HHHHHHHHHHHHHHH----H------
H-----H------H------H##########H
H-----H------H------H----------H
H-----H------H------H----------H
H-----H------H######H----------H
#############H-----------------H
######-------H----------H####H##
#---##-------H----------H----H--
#---##-------H---HHHHHHHH----H--
#########H########------H---####
---------H--------------H-------
---------H--------------H-------
---------H--------------H-------
################################
